16 4  5  4  5  4  4  4  5  4  4  5  4  4  4  5  4  4  5  4  4  5  4  4  5  5  5  4  4  5  5  4  4  17
6  0  0  0  0  0  0  0  0  0  0  0  0  0  0  0  0  0  0  0  0  0  0  0  0  0  0  0  0  0  0  0  0  7
8  0  0  0  0  0  0  0  0  0  0  0  0  0  0  0  0  0  0  0  0  0  0  0  0  0  0  0  0  0  0  0  0  7
6  0  0  0  0  0  0  0  0  0  0  0  0  0  0  0  0  0  0  0  0  0  0  0  0  0  0  0  0  0  0  2  2  7
6  0  0  0  0  0  0  0  0  0  0  11 2  2  3  10 0  0  0  0  0  0  0  0  0  0  0  0  0  0  0  0  0  7
6  0  0  0  0  0  0  0  0  0  0  7  1  1  1  8  0  0  0  0  0  0  0  0  0  0  0  0  0  0  0  0  0  7
14 2  2  2  3  3  2  3  2  2  2  15 1  1  1  14 2  2  2  2  2  2  2  2  2  2  2  2  2  3  3  3  2  15
1  1  1  1  1  1  1  1  1  1  1  1  1  1  1  1  1  1  1  1  1  1  1  1  1  1  1  1  1  1  1  1  1  1
1  1  1  1  1  1  1  1  1  1  1  1  1  1  1  1  1  1  1  1  1  1  1  1  1  1  1  1  1  1  1  1  1  1