16 4  5  4  5  4  4  4  5  4  4  5  4  4  4  5  4  4  5  4  4  5  4  4  5  5  5  4  4  5  5  4  4  17 16 4  5  4  5  4  4  4  5  4  4  5  4  4  4  5  4  4  5  4  4  5  4  4  5  5  5  4  4  5  5  4  4  4
6  0  0  0  0  0  0  0  0  0  0  0  0  0  0  0  0  0  0  0  0  0  0  0  0  0  0  0  0  0  0  0  0  0  0  0  0  0  0  0  0  0  0  0  0  0  0  0  0  0  0  0  0  0  0  0  0  0  0  0  0  0  0  0  0  0  0  0
8  0  0  0  0  0  0  0  0  0  0  0  0  0  0  0  0  0  0  0  0  0  0  0  0  0  0  0  0  0  0  0  0  0  0  0  0  0  0  0  0  0  0  0  0  0  0  0  0  0  0  0  0  0  0  0  0  0  0  0  0  0  0  0  0  0  0  0
6  0  0  0  0  0  0  0  0  0  0  0  0  0  0  0  0  0  0  0  0  0  0  0  0  0  0  0  0  0  0  0  0  0  0  0  0  0  0  0  0  0  0  0  0  0  0  0  0  0  0  0  0  0  0  0  0  0  0  0  0  0  0  0  0  0  0  0
8  0  0  0  0  0  0  0  0  0  0  0  0  0  0  0  0  0  0  0  0  0  0  0  0  0  0  0  0  0  0  0  0  0  0  0  0  0  0  0  0  0  0  0  0  0  0  0  0  0  0  0  0  0  0  0  0  0  0  0  0  0  0  0  11 2  2  2
6  0  0  0  0  0  0  0  0  0  0  0  0  0  0  0  0  0  11 2  2  2  10 0  0  0  0  11 2  10 0  0  11 2  2  10 0  0  0  0  0  0  0  0  0  0  0  0  0  11 2  2  10 0  0  0  0  0  0  0  0  0  11 2  15 1  1  1
6  0  0  0  0  0  0  0  0  0  0  0  0  0  0  0  0  0  13 5  4  5  12 0  0  0  0  7  1  6  0  0  13 5  5  12 0  0  0  0  0  0  0  0  0  0  0  0  0  7  1  1  6  0  0  0  0  0  0  0  0  0  7  1  1  1  1  1
6  0  0  0  0  0  0  0  0  0  11 2  2  3  3  10 0  0  0  0  0  0  0  0  0  11 2  15 1  6  0  0  0  0  0  0  0  0  11 2  2  10 0  0  0  11 3  2  3  15 1  1  14 2  2  10 0  0  0  0  11 2  15 1  1  1  1  1
6  0  0  0  0  0  0  0  0  0  7  1  1  1  1  6  0  0  0  0  0  0  0  0  0  7  1  1  1  6  0  0  0  0  0  0  0  0  7  1  1  6  0  0  0  7  1  1  1  1  1  1  1  1  1  6  0  0  0  0  7  1  1  1  1  1  1  1
14 2  2  2  2  2  2  2  2  2  15 1  1  1  1  14 2  2  2  2  2  2  2  2  2  15 1  1  1  14 2  2  2  2  2  2  2  2  15 1  1  14 2  2  2  15 1  1  1  1  1  1  1  1  1  14 2  2  2  2  15 1  1  1  1  1  1  1
1  1  1  1  1  1  1  1  1  1  1  1  1  1  1  1  1  1  1  1  1  1  1  1  1  1  1  1  1  1  1  1  1  1  1  1  1  1  1  1  1  1  1  1  1  1  1  1  1  1  1  1  1  1  1  1  1  1  1  1  1  1  1  1  1  1  1  1